"filename", "language", "HTML", "Markdown", "JavaScript", "XML", "CSS", "comment", "blank", "total"
"d:\total\exp\softwareability\project\cloudswjtu_total_2022.12.26\404.html", "HTML", 50, 0, 0, 0, 0, 1, 12, 63
"d:\total\exp\softwareability\project\cloudswjtu_total_2022.12.26\README.md", "Markdown", 0, 68, 0, 0, 0, 0, 42, 110
"d:\total\exp\softwareability\project\cloudswjtu_total_2022.12.26\bootstrap\css\bootstrap-theme.css", "CSS", 0, 0, 0, 0, 581, 6, 0, 587
"d:\total\exp\softwareability\project\cloudswjtu_total_2022.12.26\bootstrap\css\bootstrap-theme.min.css", "CSS", 0, 0, 0, 0, 1, 5, 0, 6
"d:\total\exp\softwareability\project\cloudswjtu_total_2022.12.26\bootstrap\css\bootstrap.css", "CSS", 0, 0, 0, 0, 6826, 8, 0, 6834
"d:\total\exp\softwareability\project\cloudswjtu_total_2022.12.26\bootstrap\css\bootstrap.min.css", "CSS", 0, 0, 0, 0, 1, 5, 0, 6
"d:\total\exp\softwareability\project\cloudswjtu_total_2022.12.26\bootstrap\fonts\glyphicons-halflings-regular.svg", "XML", 0, 0, 0, 288, 0, 0, 0, 288
"d:\total\exp\softwareability\project\cloudswjtu_total_2022.12.26\bootstrap\jQuery\jquery-3.6.1.js", "JavaScript", 0, 0, 6902, 0, 0, 1922, 2086, 10910
"d:\total\exp\softwareability\project\cloudswjtu_total_2022.12.26\bootstrap\js\bootstrap.js", "JavaScript", 0, 0, 1752, 0, 0, 211, 618, 2581
"d:\total\exp\softwareability\project\cloudswjtu_total_2022.12.26\bootstrap\js\bootstrap.min.js", "JavaScript", 0, 0, 1, 0, 0, 5, 0, 6
"d:\total\exp\softwareability\project\cloudswjtu_total_2022.12.26\bootstrap\js\npm.js", "JavaScript", 0, 0, 12, 0, 0, 1, 0, 13
"d:\total\exp\softwareability\project\cloudswjtu_total_2022.12.26\css\base.css", "CSS", 0, 0, 0, 0, 17, 5, 3, 25
"d:\total\exp\softwareability\project\cloudswjtu_total_2022.12.26\css\common.css", "CSS", 0, 0, 0, 0, 716, 28, 23, 767
"d:\total\exp\softwareability\project\cloudswjtu_total_2022.12.26\css\css.css", "CSS", 0, 0, 0, 0, 336, 4, 10, 350
"d:\total\exp\softwareability\project\cloudswjtu_total_2022.12.26\css\denglu.css", "CSS", 0, 0, 0, 0, 222, 4, 38, 264
"d:\total\exp\softwareability\project\cloudswjtu_total_2022.12.26\css\displayphoto.css", "CSS", 0, 0, 0, 0, 52, 0, 7, 59
"d:\total\exp\softwareability\project\cloudswjtu_total_2022.12.26\css\griddisplay.css", "CSS", 0, 0, 0, 0, 390, 0, 46, 436
"d:\total\exp\softwareability\project\cloudswjtu_total_2022.12.26\css\index.css", "CSS", 0, 0, 0, 0, 529, 20, 98, 647
"d:\total\exp\softwareability\project\cloudswjtu_total_2022.12.26\css\navstyle.css", "CSS", 0, 0, 0, 0, 177, 0, 2, 179
"d:\total\exp\softwareability\project\cloudswjtu_total_2022.12.26\css\pictrans.css", "CSS", 0, 0, 0, 0, 0, 0, 1, 1
"d:\total\exp\softwareability\project\cloudswjtu_total_2022.12.26\css\sec.css", "CSS", 0, 0, 0, 0, 19, 1, 2, 22
"d:\total\exp\softwareability\project\cloudswjtu_total_2022.12.26\css\shangchuan-dibiao.css", "CSS", 0, 0, 0, 0, 55, 0, 8, 63
"d:\total\exp\softwareability\project\cloudswjtu_total_2022.12.26\css\style.css", "CSS", 0, 0, 0, 0, 118, 6, 2, 126
"d:\total\exp\softwareability\project\cloudswjtu_total_2022.12.26\css\stylefuwuqu.css", "CSS", 0, 0, 0, 0, 74, 0, 7, 81
"d:\total\exp\softwareability\project\cloudswjtu_total_2022.12.26\css\temphub.css", "CSS", 0, 0, 0, 0, 53, 0, 1, 54
"d:\total\exp\softwareability\project\cloudswjtu_total_2022.12.26\doc\README副本.md", "Markdown", 0, 68, 0, 0, 0, 0, 42, 110
"d:\total\exp\softwareability\project\cloudswjtu_total_2022.12.26\fuwuquzhidao.html", "HTML", 188, 0, 0, 0, 0, 2, 33, 223
"d:\total\exp\softwareability\project\cloudswjtu_total_2022.12.26\index.html", "HTML", 482, 0, 0, 0, 0, 9, 12, 503
"d:\total\exp\softwareability\project\cloudswjtu_total_2022.12.26\index1.html", "HTML", 40, 0, 0, 0, 0, 0, 3, 43
"d:\total\exp\softwareability\project\cloudswjtu_total_2022.12.26\index2.html", "HTML", 126, 0, 0, 0, 0, 6, 12, 144
"d:\total\exp\softwareability\project\cloudswjtu_total_2022.12.26\jdhistory.html", "HTML", 87, 0, 0, 0, 0, 2, 11, 100
"d:\total\exp\softwareability\project\cloudswjtu_total_2022.12.26\js\animate.js", "JavaScript", 0, 0, 12, 0, 0, 0, 1, 13
"d:\total\exp\softwareability\project\cloudswjtu_total_2022.12.26\js\click.js", "JavaScript", 0, 0, 14, 0, 0, 0, 0, 14
"d:\total\exp\softwareability\project\cloudswjtu_total_2022.12.26\js\denglu.js", "JavaScript", 0, 0, 13, 0, 0, 2, 2, 17
"d:\total\exp\softwareability\project\cloudswjtu_total_2022.12.26\js\displayphoto.js", "JavaScript", 0, 0, 78, 0, 0, 1, 7, 86
"d:\total\exp\softwareability\project\cloudswjtu_total_2022.12.26\js\imgUpload.js", "JavaScript", 0, 0, 82, 0, 0, 7, 7, 96
"d:\total\exp\softwareability\project\cloudswjtu_total_2022.12.26\js\mousecheck.js", "JavaScript", 0, 0, 23, 0, 0, 6, 1, 30
"d:\total\exp\softwareability\project\cloudswjtu_total_2022.12.26\js\myjavascript.js", "JavaScript", 0, 0, 343, 0, 0, 14, 7, 364
"d:\total\exp\softwareability\project\cloudswjtu_total_2022.12.26\js\shangchuan.js", "JavaScript", 0, 0, 37, 0, 0, 19, 7, 63
"d:\total\exp\softwareability\project\cloudswjtu_total_2022.12.26\js\temp.html", "HTML", 12, 0, 0, 0, 0, 0, 6, 18
"d:\total\exp\softwareability\project\cloudswjtu_total_2022.12.26\js\test.js", "JavaScript", 0, 0, 1, 0, 0, 0, 1, 2
"d:\total\exp\softwareability\project\cloudswjtu_total_2022.12.26\nav.html", "HTML", 84, 0, 0, 0, 0, 0, 2, 86
"d:\total\exp\softwareability\project\cloudswjtu_total_2022.12.26\navaside.html", "HTML", 43, 0, 0, 0, 0, 0, 0, 43
"d:\total\exp\softwareability\project\cloudswjtu_total_2022.12.26\swjtudb.html", "HTML", 1190, 0, 0, 0, 0, 134, 10, 1334
"d:\total\exp\softwareability\project\cloudswjtu_total_2022.12.26\test\README.md", "Markdown", 0, 1, 0, 0, 0, 0, 0, 1
"d:\total\exp\softwareability\project\cloudswjtu_total_2022.12.26\tiyujiankang.html", "HTML", 92, 0, 0, 0, 0, 6, 4, 102
"d:\total\exp\softwareability\project\cloudswjtu_total_2022.12.26\wenhuayishu.html", "HTML", 90, 0, 0, 0, 0, 6, 3, 99
"d:\total\exp\softwareability\project\cloudswjtu_total_2022.12.26\xiaoyuanfuwu.html", "HTML", 85, 0, 0, 0, 0, 6, 3, 94
"d:\total\exp\softwareability\project\cloudswjtu_total_2022.12.26\zhiyuangongyi.html", "HTML", 71, 0, 0, 0, 0, 6, 4, 81
"d:\total\exp\softwareability\project\cloudswjtu_total_2022.12.26\登录&注册.html", "HTML", 157, 0, 0, 0, 0, 7, 24, 188
"Total", "-", 2797, 137, 9270, 288, 10167, 2465, 3208, 28332